> S >>>>>>>>>>>>>>>>>>>>>>>>>>>>>>>>>
>   > * >   >         > *       >   >
>   >   >   >>>>>>>   >>>>>>>   >   >
>   >                           >   >
>   >>>>>   >>>   >   >>>   >   >   >
>   >        *>   >   >     > * > * >
>   >   >   >>>>>>>   >>>   >>>>>    
>   > * >         >   * >   >       E
>   >>>>>   >     >>>>>>>   >   >    
>           >     >             >   >
>   >>>>>>>>>     >         >   >   >
>                 >         >   >>>>>
>>>>>> *  >>>>>>>>>>>>>     >       >
>           >         >     >  *    >
>           >  *            >       >
>>>>>>>>>>>>>>>>>>>>>>>>>>>>>>>>>>>>>          